............................................................................................................................................................................................................................................................
............................................................................................................................................................................................................................................................
............................................................................................................................................................................................................................................................
............................................................................................................................................................................................................................................................
............................................................................................................................................................................................................................................................
............................................................................................................................................................................................................................................................
............................................................................................................................................................................................................................................................
............................................................................................................................................................................................................................................................
............................................................................................................................................................................................................................................................
............................................................................................................................................................................................................................................................
............................................................................................................................................................................................................................................................
............................................................................................................................................................................................................................................................
............................................................................................................................................................................................................................................................
............................................................................................................................................................................................................................................................
............................................................................................................................................................................................................................................................
............................................................................................................................................................................................................................................................
......#...................................................................................#...................................................................................#.............................................................................
......#..............#.......@............................................................#..............#....................................................................#..............#..............................................................
------------------------------------------------------------------------------------------------------------------------------------------------------------------------------------------------------------------------------------------------------------
------------------------------------------------------------------------------------------------------------------------------------------------------------------------------------------------------------------------------------------------------------
