............................................................................................................................................................................................................................................................
............................................................................................................................................................................................................................................................
............................................................................................................................................................................................................................................................
............................................................................................................................................................................................................................................................
............................................................................................................................................................................................................................................................
............................................................................................................................................................................................................................................................
............................................................................................................................................................................................................................................................
............................................................................................................................................................................................................................................................
..........................@.................................................................................................................................................................................................................................
............................................................................................................................................................................................................................................................
....................................#.......................................................................................................................................................................................................................
....................................#.......................................................................................................................................................................................................................
....................................#.......................................................................................................................................................................................................................
....................................#.......................................................................................................................................................................................................................
....................................#.......................................................................................................................................................................................................................
....................................#.......................................................................................................................................................................................................................
......#.............................#.....................................................#...................................................................................#.............................................................................
......#..............#..............#......................................................#..............#....................................................................#..............#..............................................................
------------------------------------------------------------------------------------------------------------------------------------------------------------------------------------------------------------------------------------------------------------
------------------------------------------------------------------------------------------------------------------------------------------------------------------------------------------------------------------------------------------------------------
