............................................................................................................................................................................................................................................................
............................................................................................................................................................................................................................................................
............................................................................................................................................................................................................................................................
............................................................................................................................................................................................................................................................
............................................................................................................................................................................................................................................................
............................................................................................................................................................................................................................................................
............................................................................................................................................................................................................................................................
............................................................................................................................................................................................................................................................
............................................................................................................................................................................................................................................................
............................................................................................................................................................................................................................................................
....................................#.......................................................................................................................................................................................................................
....................................#.......................................................................................................................................................................................................................
....................................#.......................................................................................................................................................................................................................
.............@.........##...........#.......................................................................................................................................................................................................................
....................##..............#.......................................................................................................................................................................................................................
................##..................#.......................................................................................................................................................................................................................
......#.............................#.....................................................#...................................................................................#.............................................................................
......#..............#..............#.....................................................#..............#....................................................................#..............#..............................................................
------------------------------------------------------------------------------------------------------------------------------------------------------------------------------------------------------------------------------------------------------------
------------------------------------------------------------------------------------------------------------------------------------------------------------------------------------------------------------------------------------------------------------
