............................................................................................................................................................................................................................................................
............................................................................................................................................................................................................................................................
............................................................................................................................................................................................................................................................
............................................................................................................................................................................................................................................................
............................................................................................................................................................................................................................................................
............................................................................................................................................................................................................................................................
............................................................................................................................................................................................................................................................
............................................................................................................................................................................................................................................................
............................................................................................................................................................................................................................................................
............................................................................................................................................................................................................................................................
...................""""""...........#.......................................................................................................................................................................................................................
..........."""".............##.#....#.........................."............................................................................................................................................................................................
..................G.."....#.........#.......................................................................................................................................................................................................................
.............@.........##...........#.......................................................................................................................................................................................................................
....................##..............#.....................**..................................................................................................................................................................................................
............##..##.......??.........#.......................................................................................................................................................................................................................
......#.............................#.....................................................#...................................................................................#.............................................................................
......#..............#..............#.....................................................#..............#....................................................................#..............#..............................................................
------------------------------------------------------------------------------------------------------------------------------------------------------------------------------------------------------------------------------------------------------------
------------------------------------------------------------------------------------------------------------------------------------------------------------------------------------------------------------------------------------------------------------
