............................................................................................................................................................................................................................................................
............................................................................................................................................................................................................................................................
............................................................................................................................................................................................................................................................
............................................................................................................................................................................................................................................................
............................................................................................................................................................................................................................................................
...............................................................................................................................O............................................................................................................................
............................................................................................................................................................................................................................................................
............................................................................................................................................................................................................................................................
............................................................................................................................................................................................................................................................
............................................................................................................................................................................................................................................................
....................................#....................................................................................O..................................................................................................................................
............................##.#....#.........................."............................................................................................................................................................................................
..................G.."....#.........#.............................................................................................O.........................................................................................................................
.............@.........##...........#.......................................................................................................................................................................................................................
....................##..............#.....................**..................................................................................................................................................................................................
............##..##.......??.........#.......................................................................................................................................................................................................................
......#......................................................................................................................................................................#.............................................................................
......#..............#..................................................................................#......................T.............................................#..............#.......................................................F......
------------------------------------------------------------------------------------------------------------------------------------------------------------------------------------------------------------------------------------------------------------
------------------------------------------------------------------------------------------------------------------------------------------------------------------------------------------------------------------------------------------------------------
