............................................................................................................................................................................................................................................................
............................................................................................................................................................................................................................................................
............................................................................................................................................................................................................................................................
............................................................................................................................................................................................................................................................
............................................................................................................................................................................................................................................................
............................................................................................................................................................................................................................................................
............................................................................................................................................................................................................................................................
............................................................................................................................................................................................................................................................
............................................................................................................................................................................................................................................................
............................................................................................................................................................................................................................................................
............................................................................................................................................................................................................................................................
..............O.............................................................................................................................................................................................................................................
....................................................*.......................................................................................................................................................................................................
.............@.......O..............................*.......................................................................................................................................................................................................
.............................???.................*..*.......................................................................................................................................................................................................
.................................................*..*.......................................................................................................................................................................................................
.............................................*...*..*......................................................................................................................................................................................................
.................T...G.......###.............*...*..*......................................................................................................................................................................................................
----------------------------------------------- --- --------------------------------------------------------------------------------------------------------------------------------------------------------------------------------------------------------
----------------------------------------------- --- --------------------------------------------------------------------------------------------------------------------------------------------------------------------------------------------------------
